# 中國用語 → 台灣用語 對照表
# 格式: 中國用語=台灣用語
# 以 # 開頭的行為註解

# === 電腦相關 ===
屏幕=螢幕
視頻=影片
軟件=軟體
硬件=硬體
程序=程式
網絡=網路
信息=訊息
默認=預設
激活=啟用
優化=最佳化
支持=支援
鼠標=滑鼠
光標=游標
內存=記憶體
硬盤=硬碟
打印=列印
人工智能=人工智慧
數據=資料
文檔=文件
質量=品質

# === 網路相關 ===
視頻網站=影音網站
網絡遊戲=網路遊戲
網吧=網咖
寬帶=寬頻
服務器=伺服器
博客=部落格
帖子=貼文

# === 生活用語 ===
出租車=計程車
地鐵=捷運
公交車=公車
優盤=隨身碟
移動硬盤=行動硬碟
筆記本=筆電
台式機=桌機

# === 遊戲術語 ===
角色=角色
技能=技能
裝備=裝備
副本=副本
